08mälardalen 8 Mälardalen mail: petra.israelsson@unt.se
adelfoza Adelfo Zarazua mail: adelfo.zarazua@unt.se
agnetaka Agneta Karlsson mail: agneta.karlsson@nt.se
agnetalo Agneta Lorentzon mail: agneta.lorentzon@uppsalatidningen.se
agnetawa Agneta Wallström mail: agneta.wallstrom@kuriren.com
agnethage Agnetha Gevhagen mail: agnetha.gevhagen@nt.se
alexanderja Alexander Jakobsson mail: alexander.jakobsson@ntm.eu
alexandrael Alexandra Eldh mail: alexandra.eldh@folkbladet.se
alfonsoma Alfonso Marin mail: alfonso.marin@unt.se
amandaan Amanda Andersson mail: amanda.andersson@ntm.eu
amandaba Amanda Silvering mail: amanda.silvering@gotlandsmedia.se
amandaek Amanda Ekberg mail: 
amandaro Amanda Rohnström mail: amanda.rohnstrom@gotlandsmedia.se
amandasc Amanda Schulin mail: amanda.schulin@ntm.eu
amos  Amos mail: 
andersfe Anders Ferm mail: anders.ferm@ntm.eu
andersja Anders Järnberg mail: anders.jernberg@norrbottensmedia.se
anderskä Anders Källman mail: anders.kallman@norrbottensmedia.se
andersla Anders Lampa mail: anders.lampa@norrbottensmedia.se
andersni Anders Nilsson mail: anders.h.nilsson@ntm.eu
anderssa Anders Sandle mail: anders.sandle@norrbottensmedia.se
anderssv Anders Svensson mail: anders.svensson@norrbottensmedia.se
andkla Andreas Claesson mail: andreas.klasson@corren.se
andreasen Andreas Engmark mail: andreas.engmark@corren.se
andreasha Andreas Hall mail: andreas.hall@unt.se
andreasla Andreas Larsson mail: andreas.larsson@corren.se
andreasli Andreas Lindgren mail: andreas.a.lindgren@ntm.eu
andreasno Andreas Norberg mail: andreas.norberg@ntm.eu
andreasse Andreas Selberg mail: andreas.selberg@norrbottensmedia.se
anette07 Anette Johansson mail: anette.johansson@vt.se
anetteas Anette Asplund mail: anette.asplund@corren.se
anettegr Anette Grehn mail: anette.grehn@unt.se
anettegy Anette Gyllander mail: anette.gyllander@nt.se
anetteho Anette Holmbom mail: anette.holmbom@norrbottensmedia.se
anetteka Anette Karlsson mail: anette.karlsson@corren.se
anettela Anette Lack mail: anette.lack@ntm.eu
anettelu Anette Lundin mail: anette.lundin@ntm.eu
anettest Anette Steen mail: anette.steen@corren.se
anetteste Anette Steen mail: anette.steen@corren.se
angelicabe Angelica Bergman mail: angelica.bergman@unt.se
anitagu Anita Gustafsson mail: anita@norrauppland.se
anitalj Anita Ljung mail: anita.ljung@nt.se
anitani Anita Nilsson mail: anita.nilsson@norrbottensmedia.se
ankiåv Anki Åvall mail: anki.avall@nt.se
ann-caroline Ann-Caroline Berglund mail: anncaroline.berglund@gotlandsmedia.se
ann-chriseg Ann-Christine Egnell mail: ann.egnell@nt.se
ann-soffieta Ann-Sofie Taleman mail: taleman@nt.se
anna-karinlu Anna-Karin Lundgren mail: anna-karin.lundgren@inorr.se
anna-lenasa Anna-Lena Säfström mail: anna-lena.safstrom@unt.se
annaar Anna Arner mail: anna.arner@ntm.eu
annael Anna Elbkvist mail: anna.elbkvist@ntm.eu
annafa Anna Farhadi mail: anna.farhadi@ntm.eu
annafu Anna Fuhrman mail: anna.fuhrman@unt.se
annakarinro Anna-Karin Romin mail: anna-karin.romin@gotlandsmedia.se
annalenapa Anna-Lena Palmqvist mail: anna-lena.palmqvist@norrbottensmedia.se
annali Anna Lindvall mail: 
annane Anna Nestun mail: anna.nestun@corren.se
annaph Anna Philipson mail: anna.philipson@ntm.eu
annaro Anna Rosenfors mail: anna.rosenfors@norrbottensmedia.se
annasa Anna Säfström mail: anna.safstrom@corren.se
annast Anna Stark mail: anna.stark@unt.se
annastark Anna Stark mail: anna.stark@unt.se
annayo Anna Yones mail: anna.yones@unt.se
anncathrinema Ann-Cathrine Mattsson mail: ann-cathrine@norrauppland.se
anncatrinese Anncatrine Segerljung mail: anncatrine.segerljung@uppsalatidningen.se
anncatrinåh Ann-Catrin Åhman mail: anncatrin.ahman@nt.se
anneg Ann-Christine Egnell mail: ann.egnell@ntm.eu
annela Anne Larsson mail: anne.larsson@nt.se
anneliek Anneli Ekström mail: anneli.ekstrom@unt.se
annelieli Anneli Lindberg mail: annelie.lindberg@ntm.eu
annelieto Annelie Tollerå mail: annelie.tollera@ntm.eu
annelila Anneli Larsson mail: anneli.larsson@corren.se
annelist Anneli Stenberg mail: anneli.stenberg@norrbottensmedia.se
anneljö Annel Jönsson mail: annel.jonsson@norrbottensmedia.se
annema Anne Martinsson mail: Anne.Martinsson@folkbladet.se
annewe Anne Weyde mail: anne.weyde@unt.se
annhe Ann Heldring mail: ann.heldring@corren.se
annicalo Annica Loquist mail: annika.loquist@gotlandsmedia.se
annicape Annica Pettersson mail: annica.pettersson@inorr.se
annicarö Annica Rönnlund mail: annica.ronnlund@norrbottensmedia.se
annicasv Annica Svensson mail: annica.soderberg@ntm.eu
anniejo Annie Johansson mail: annie.johansson@ntm.eu
anniere Annie Resare mail: annie.resare@unt.se
annikagl Annika Glim mail: annika.glim@norrbottensmedia.se
AnnikaGr Annika Granberg mail: annika.granberg@inorr.se
annkatrinli Ann-Katrin Lindqvist mail: ann-katrin.lindqvist@norrbottensmedia.se
annkristinsa Ann-Kristin Samuelsson mail: 
annlo Ann Lövgren mail: ann.lovgren@mvt.se
annmariev Ann-Mari Evling mail: ann-mari.evling@inorr.se
annmariwi Ann-Mari Wikström mail: ann-mari.wikstrom@inorr.se
annny Ann Nygren mail: ann.nygren@ntm.eu
annonsnu annons nu mail: 
annonssb annons sb mail: 
annonsöu annons öu mail: 
annst Ann-Christin Ström mail: ann-christin.strom@inorr.se
annös Ann Winkler mail: ann.winkler@unt.se
antonwe Anton Westerberg mail: anton@annonstidningen.com
anv. ej Ingalill Södermark mail: ingalill.sodermark@norrbottensmedia.se
api_teknomedia Teknomedia API mail: teknomedia@teknomedia.se
asago Åsa Göransson mail: asa.goransson@corren.se
asaor Åsa Orell mail: asa.orell-andersson@ntm.eu
asaro Åsa Roslund mail: asa.roslund@corren.se
asass Åsa Svahn Sandell mail: asa.svahn@corren.se
ASegerljung Ankie Segerljung mail: 
Avreg Motala Avreg Motala mail: marie,dahl@mvt.se
backoffice Test Backoffice mail: Test.Backoffice@ntm.eu
backoffice1 backoffice1 backoffice1 mail: backofficevikarie1@ntm.eu 
backoffice2 backoffice1 backoffice2 mail: backofficevikarie2@ntm.eu 
backoffice3 backoffice3 backoffice3 mail: backofficevikarie3@ntm.eu 
backoffice4 backoffice4 backoffice4 mail: backofficevikarie4@ntm.eu
backoffice5 backoffice5 backoffice5 mail: backofficevikarie5@ntm.eu
backoffice6 backoffice6 backoffice6 mail: backofficevikarie6@ntm.eu
backofficesju backoffice7 backoffice7 mail: backofficevikarie7@ntm.eu
barbrono Barbro Notgren mail: barbro.notgren@inorr.se
barbrony Barbro Nygren mail: barbro.nygren@pitea-tidningen.se
bengtma Bengt Malm mail: bengt.malm@nt.se
beritak Berit Åkerham mail: berit.akerham@unt.se
bettan Elisabeth Svensson mail: elisabeth.svensson@nt.se
birgittaek Birgitta Ekström mail: birgitta.ekstrom@nt.se
birgitwe Birgit Werkelin mail: birgit.werkelin@gotlandsmedia.se
bjornst Björn Sturehed mail: bjorn.sturehed@corren.se
björnah Björn Ahlqvist mail: bjorn.ahlqvist@gotlandspress.se
björnbe Björn Bergman mail: bjorn.bergman@gotlandsmedia.se
björnha Björn Hammar mail: bjorn.hammar@unt.se
björnja Björn Jacobsson mail: bjorn.jacobsson@nt.se
björnla Björn Langvik mail: bjorn.langvik@corren.se
björnwa Björn Wallentin mail: bjorn.wallentin@gotlandsmedia.se
bodilda Bodil Dahlqvist mail: bodil.dahlqvist@nt.se
bodilos Bodil Östman mail: bodil.ostman@unt.se
bostadmo Gruppen NTBostadMotor mail: claes.warner@nt.se
brittaha Britta Hansson mail: Britta.Hansson@norrbottensmedia.se
brittan Britt-Marie Andersson mail: 
business Gruppen NTB2B mail: johan.bergils@nt.se
caisaol Caisa Olsson mail: caisa.olsson@gotlandsmedia.se
camillajo Camilla Johansson mail: camilla.johansson@nt.se
camillajoh Cam. Johansson mail: camilla.johansson@corren.se
camillakr Camilla Kruukka mail: camilla.kruukka@norrbottensmedia.se
camillakv Camilla Kvist mail: camilla.kvist@unt.se
camillali Camilla Lindberg mail: camilla.lindberg@nt.se
camillape Camilla Persson mail: camilla.persson@vt.se
carinaca Carina Carlsson mail: carina.carlsson@norrbottensmedia.se
carinajo Carina Johansson mail: carina.johansson@unt.se
carinst Carin Stenhammar mail: carin.stenhammar@ntm.eu
carlhenrikti Carl-Henrik Tibblin mail: carl-henrik.tibblin@unt.se
carlsc Carl Schnell mail: carl.schnell@corren.se
carolast Carola Strömberg mail: carola.stromberg@norrbottensmedia.se
carolinaid Carolina Ideståhl mail: carolina.idestahl@ntm.eu
carolinege Caroline Genet mail: caroline.genet@ostgotamedia.se
carolinepe Caroline Petersson mail: caroline.petersson@nordostran.se
carolinka Carolin Karlsson mail: carolin.karlsson@norrbottensmedia.se
catarinaau Catarina Auvoja mail: catarina.auvoja@ntm.eu
catarinast Catarina Stolt mail: catarina.stolt@corren.se
catarinaza Catarina Zarazua mail: catarina.zarazua@unt.se
cathrineli Cathrine Lidman mail: cathrine.lidman@norrbottensmedia.se
catrineca Catrine Carlsson mail: catrine.carlsson@ntm.eu
ceciliabo Cecilia Bornström mail: cecilia.bornstrom@ntm.eu
ceciliael Cecilia Ellehammar mail: cecilia.ellehammar@ntm.se
ceciliaha Cecilia Hammander mail: cecilia.hammander@gotlandsmedia.se
ceciliawe Cecilia Wessman mail: cecilia.wessman@ntm.eu
charinaan Charina Andersson mail: charina.andersson@ntm.eu
charlesca Charles Carlfjord mail: 
charlottehä Charlotte Härnvi mail: charlotte.harnvi@unt.se
charlottehö Charlotte Hörngren mail: charlotte.horngren@unt.se
charlotteno Charlotte Strandberg mail: charlotte.strandberg@unt.se
Chatarinast Chatarina Strand mail: chatarina.strand@norrbottensmedia.se
christerfr Christer Freij mail: christer.freij@folkbladet.se
christerfu Christer Furuhäll mail: christer.furuhall@gotlandsmedia.se
christerti Christer Tina mail: christer.tina@norrbottensmedia.se
christian Christian Åvall mail: christian.avall@ntm.eu
christianju Christian Jubrink mail: christian.jubrink@ntm.eu
christianol Christian Olsson mail: christian.olsson@gotlandsmedia.se
christinaah Christina Ählman mail: christina.ahlman@nt.se
christinaan Christina Andersson mail: christina.andersson@nt.se
christinain Christina Invervo mail: christina.invervo@ntm.eu
christinama Christina Markström mail: christina.markstrom@norrbottensmedia.se
christinape Christina Pettersson mail: christina.pettersson@gotlandsmedia.se
christinasp Christina Spännar mail: christina.spannar@ntm.eu
christinaår Christina Åresten-Holm mail: christina.aresten-holm@unt.se
christofferha Christoffer Hallberg mail: christoffer.hallberg@ntm.eu
christofferni Christoffer Nilsson mail: christoffer.nilsson@gotlandsmedia.se
christoffernil Christoffer Nilsson mail: christoffer.nilsson@gotlandsmedia.se
claespe Claes Pettersson mail: claes.pettersson@ntm.eu
claeswä Claes Wärner mail: claes.warner@nt.se
co b2b  CO B2B mail: 
co bom  CO BoM mail: 
coannons annons CO mail: 
codetalj  CO Detalj mail: 
connyjo Conny Johansson mail: conny@annonstidningen.com
dager Dag Eriksson mail: dag.eriksson@nt.se
daglu Dag Lundblad mail: dag.lundblad@vt.se
danielan Daniel Andersson mail: daniel.andersson@corren.se
danieland Daniel Andersson mail: daniel.andersson@unt.se
danielgu Daniel Gustavsson mail: daniel.gustavsson@nt.se
danielmo Daniel Mohlén mail: daniel.mohlen@unt.se
danielth Daniel Thapper mail: danielnt.thapper@ntm.eu
davidmi David Miranda mail: david.miranda@teknomedia.se
davidni David Nilsson mail: david.nilsson@norrbottensmedia.se
dennisst Dennis Strömberg mail: dennis.stromberg@ntm.eu
dennizka Denniz Kavazovic mail: denniz.kavazovic@ntm.eu
detaljist Gruppen NTDetalj mail: anki.avall@nt.se
dianaru Diana Rudka mail: diana.rudka@unt.se
dzejnasm Dzejna Smajlovic mail: dzejna.smajlovic@ntm.eu
eevaan Eeva Andersson mail: eeva.andersson@vt.se
efrosinitr Efrosini Trikilis mail: efrosini.trikilis@ntm.eu
elainema Elaine Marklund mail: elaine.marklund@norrbottensmedia.se
elinen Elin Engström mail: elin.engstrom@ntm.eu
elinjo Elin Johansson mail: elin.johansson@norrbottensmedia.se
elinka Elin Karlsson mail: elin.karlsson@ntm.eu
elinpa Elin Palmér mail: elin.palmer@ntm.eu
elinsu Elin Sundqvist mail: elin.sundqvist@nmdistribution.se
elisabethan Elisabeth Antonsen mail: elisabeth.antonsen@ntm.eu
elisabethbl Elisabeth Blom mail: elisabeth.blom@kuriren.com
elisabethlu Elisabeth Valdemarsson mail: elisabeth.lundstrom@norrbottensmedia.se
elizabethbl Elizabeth Blom mail: elizabeth.blom@gotlandsmedia.se
elkekr Elke Krichau mail: elke.krichau@ntm.eu
ellenli Ellen Liljeqvist mail: ellen.liljeqvist@nt.se
elvirasu Elvira Sundqvist mail: elvira.sundqvist@ntm.eu
emeliabr Emelia Brännström mail: emelia.brannstrom@norrbottensmedia.se
Emelieba Emelie van Baars mail: 
emeliejo Emelie Johansson mail: emelie.johansson@ntm.eu
emelielj Emelie Ljungblad mail: 
emelieri Emelie Ribbert mail: emelie.ribbert@corren.se
emeliero Emelie Rosendahl mail: emelie.rosendahl@nt.se
Emelieva Emelie van Baars mail: emelie.van.baars@ntm.eu
Emil Emil Sandbladh mail: emil.sandbladh@nt.se
emilol Emil Olsenmyr mail: emil.olsenmyr@unt.se
emmaem Emma Emanuelsson mail: emma.emanuelsson@ntm.eu
emmagu Emma Gustavsson mail: emma.gustavsson@norrbottensmedia.se
EmmaMa Emma Mattsson mail: emma.mattson@nt.se
emmani Emma Nilsson mail: emma.nilsson@meralinkoping.se
emmaud Emma Uddenberg mail: emma.uddenberg@ntm.eu
emmawe Emma West mail: emma.west@corren.se
emmiema Emmie Marmont mail: emmie.marmont@gotlandsmedia.se
emmyhö Emmy Hökby mail: emmy.hokby@gotlandsmedia.se
Emyse Emy Serander mail: emy.serander@ntm.eu
ericabo Erica Bohman mail: erica.bohman@ntm.eu
ericama Erica Marcus mail: erica.marcus@ntm.eu
ericavi Erica Viklund mail: erica.viklund@norrbottensmedia.se
erikaha Erika Hauer mail: erika.hauer@ntm.eu
erikami Erika Mikander mail: erika.mikander@ntm.eu
erikes Erik Espinoza mail: erik.espinoza@gotlandsmedia.se
erikha Erik Hansson mail: erik.hansson@gotlandsmedia.se
erikma Erik Malmstig mail: erik.malmstig@unt.se
erikpe Erik Pexer mail: erik.pexer@teknomedia.se
erjape Erja Persson mail: erja.persson@norrbottensmedia.se
ethelke Ethel Keisu mail: ethel.keisu@kuriren.com
evaan Eva Andersson mail: eva.andersson@ntm.eu
evabo Eva Bodin mail: eva.bodin@ntm.eu
evaek Eva Ekerfeldt mail: eva.ekerfeldt@corren.se
evahe Eva Hedström mail: eva.hedstrom@inorr.se
evaka Eva Karlsson mail: eva.karlsson@norrbottensmedia.se
evalenaki Eva-Lena Kindkvist mail: 
evalenali Eva-Lena Lindkvist mail: eva-lena.lindkvist@unt.se
evalenasc Eva-Lena Scharf mail: eva-lena.scharf@vt.se
evali Eva Lindberg mail: eva.lindberg@pitea-tidningen.se
evalin Eva Linder mail: eva.linder@ntm.eu
evamo Eva Möller mail: eva.moller@corren.se
evarö Eva Rönnbäck mail: eva.ronnback@pitea-tidningen.se
evasa Eva Sandström mail: eva.sandstrom@norrbottensmedia.se
evath Eva Thunblad mail: eva.thunblad@vt.se
evava Eva Purcell mail: eva.purcell@ntm.eu
evawa Eva Walther mail: eva.walther@ostgotamedia.se
evawi Eva Wirenfelt mail: eva.wirenfelt@vt.se
Evelinakl Evelina Klopsch mail: evelina.klopsch@unt.se
Ewaoh Ewa Ohlström mail: 
fannywi Fanny Winqvist mail: fanny.winqvist@mvt.se
farazta Faraz Tayyebi mail: faraz.tayyebi@uppsalatidningen.se
fbannons FB ANNONS mail: annons@folkbladet.se
filipfo Filip Fors mail: filip.fors@nt.se
franssonko Fransson Konsult mail: marcus.eriksson@nt.se
fredricär Fredric Ärlestål mail: fredric.arlestal@unt.se
fredrikbe Fredrik Berg mail: fredrik.berg@nt.se
fredrikjo Fredrik Johnsson mail: fredrik.johnsson@norrbottensmedia.se
fredrikki Fredrik Kinberg mail: fredrik.kinberg@ntm.eu
fredrikol Fredrik Olofsson mail: fredrik.olofsson@unt.se
frejas Frej Askengren mail: frej.askengren@gotlandsmedia.se
fridano Frida Norden mail: frida.norden@folkbladet.se
fridaos Frida Öström mail: frida.ostrom@norrbottensmedia.se
fridast Frida Stenbäck mail: frida.stenback@unt.se
georgewe George Wennerstrand mail: george.wennerstrand@ntm.eu
gerter Gert Eriksson mail: gert.eriksson@unt.se
gillja Gill Jansson mail: gill.jansson@nt.se
gilljan Gill Jansson mail: gill.jansson@nt.se
goranpe Göran Petersson mail: goran.pettersson@ntm.eu
goransc Göran Schmid mail: goran.schmid@vt.se
gorelja Görel Jakobsson mail: gorel.jakobsson@gotlandsmedia.se
gotlandsmedia Döda Kunder mail: annons@gotlandsmedia.se
gunbrittan Gun-Britt Andersson mail: gunbritt.andersson@kuriren.com
gunbritter Gun-Britt Eriksson mail: gun-britt.eriksson@norrbottensmedia.se
gunillaol Gunilla Olsson mail: Gunilla.Olsson@norrbottensmedia.se
gunillaols Gunilla Olsson mail: gunilla.olsson@corren.se
gunnardr Gunnar Drage mail: gunnar.drage@ntm.eu
gustafhu Gustaf Hull mail: gustaf.hull@nt.se
göranfr Göran Frid mail: 
Göranro Göran Ronnebjer mail: goran.ronnebjer@norrbottensmedia.se
haidielu Haidie Lundman mail: haidie.lundman@pitea-tidningen.se
hannaax Hanna Axelhav mail: hanna.axelhav@ntm.eu
hannabo Hanna Ullström mail: hanna.ullstrom@folkbladet.se
hannaju Hanna Junland mail: hanna.junland@mvt.se
hannapi Hanna Pie mail: hanna.pie@nt.se
hannast Hanna Sterneling mail: hanna.sterneling@ntm.eu
hannaul Hanna Ullström mail: hanna.ullstrom@folkbladet.se
hannawa Hanna Wahlberg mail: hanna.wahlberg@nt.se
hansfo Hans Frominder mail: hans.frominder@corren.se
hansgu Hans Gustavsson mail: hans.gustavsson@vt.se
hazharma Hazhar Maroufi mail: hazhar.maroufi@corren.se
helenabe Helena Bergvin mail: helena.bergvin@ntm.eu
helenada Helena Dahl mail: helena.dahl@nt.se
helenadj Helena Djerf mail: helena.djerf@nt.se
helenaki Helena Kinnunen mail: helena.kinnunen@nt.se
helenalu Helena Lundberg mail: helena.lundberg@corren.se
helenane Helena Nellsjö mail: helena.nellsjo@corren.se
helenaso Helena Söderström mail: 
helenavi Helena Vikström mail: helena.vikstrom@norrbottensmedia.se
helenha Helen Hagström mail: helen.hagstrom@nt.se
helenjo Helen Johansson mail: helen.johansson@corren.se
helenno Helen Nordensved mail: 
henrikah Henrik Ahl mail: henrik.ahl@sigtunabygden.se
Henriken Henrik Enbom mail: henrik.enbom@norrbottensmedia.se
henrikru Henrik Rundström mail: henrik.rundstrom@mvt.se
henriksv Henrik Svegsjö mail: henrik.svegsjo@gotlandsmedia.se
henrikwe Henrik Westerlund mail: henrik.westerlund@unt.se
henrype Henry Pekkari mail: henry.pekkari@norrbottensmedia.se
hildingha Hildning Håckerström mail: hilding.hackerstrom@ntm.eu
hilleviwi Hillevi Wikström mail: hillevi.wikstrom@norrbottensmedia.se
håkanbl Håkan Blomqvist mail: hakan.blomqvist@norrbottensmedia.se
håkangi Håkan Gilbertzon mail: hakan.gilbertzon@nt.se
ingalillbl Ingalill Blumfelds mail: Ingalill.Blumfelds@nt.se
ingalillgu Inga-Lill Gustafsson mail: inga-lill.gustafsson@norrbottensmedia.se
Ingalillni Ingalill Nilsson mail: ingalill.nilsson@ntm.eu
ingalillso Ingalill Södermark mail: ingalill.sodermark@norrbottensmedia.se
ingasu Inga Sundin mail: inga.sundin@corren.se
ingelato Ingela Torgerstad mail: ingela.torgerstad@norrbottensmedia.se
ingeran Inger Anundby mail: inger.anundby@kuriren.com
ingerand Inger Andersson mail: inger.andersson@nt.se
ingerda Inger Dahlgren mail: inger.dahlgren@nt.se
ingergr Inger Grotteblad mail: inger.grotteblad@unt.se
ingerhe Inger Hellman mail: inger.hellman@unt.se
ingerla Inger Landström mail: inger.landstrom@nt.se
ingerpe Inger Pettersson mail: inger.pettersson@gotlandsmedia.se
ingerto Inger Torlamb mail: inger.torlamb@folkbladet.se
ingmarieis Ing-Marie Isaksson mail: ing-marie.isaksson@kuriren.com
ingridbä Ingrid Bäck mail: ingrid.back@nt.se
ingridlu Ingrid Lundberg mail: ingrid.lundberg@corren.se
innesälj Innesälj GM mail: annons@gotlandsmedia.se
irenean Irene Anebrant mail: irene.anebrant@folkbladet.se
ireneås Irene Åström mail: irene.astrom@kuriren.com
isabellama Isabella Marin mail: isabella.marin@unt.se
isabellewi Isabelle Witkowski mail: 
ivarho Ivar Holmquist mail: ivar.holmquist@unt.se
jacquelineho Jacqueline Holmberg mail: jacqueline.holmberg@nt.se
janca Jan Carmesten mail: jan.carmesten@corren.se
jannein Janne Innala mail: janne.innala@kuriren.com
janneja Janne Jansson mail: janne.jansson@unt.se
janolofgr Jan-Olof Granqvist mail: jan-olof.granqvist@24norrbotten.se
jeanette Jeanette Åsberg mail: jeanette.asberg@norrbottensmedia.se
jeanetteas Jeanette Åsberg mail: 
jeanettehu Jeanette Hult mail: jeanette.hult@ntm.eu
jeanettejo Jeanette Johnsson mail: Jeanette.Johnsson@ntm.eu
jeanettepi Jeanette Pihl mail: jeanette.pihl@nt.se
jennieer Jennie Eriksson mail: jennie.eriksson@vt.se
jennieöh Jennie Öhlund mail: jennie.ohlund@inorr.se
jennifersy Jennifer Sylvan mail: jennifer.sylvan@mvt.se
jennyek Jenny Ekholm mail: jenny.ekholm@nt.se
jennyku Jenny Kullberg mail: jenny.kullberg@nt.se
jennyli Jenny Lingström mail: jenny.lingstrom@ntm.eu
jennysa Jenny Sandelin mail: jenny.sandelin@gotlandsmedia.se
jennysk Jenny Sköld mail: jenny.skold@gotlandsmedia.se
jennysä Jenny Sämsjö mail: jenny.samsjo@ntm.eu
jesperpe Jesper Peruzzaro mail: jesper.peruzzaro@norrbottensmedia.se
jesperper Jesper Persson mail: jesper.persson@uppsalatidningen.se
jessicasa Jessica Sandqvist mail: jessica.sandqvist@nt.se
jessicasan Jessica Sanfridsson mail: jessica.sanfridsson@gotlandsmedia.se
jessicat Jessica Tervaniemi mail: jessica.tervaniemi@norrbottensmedia.se
jessieca Jessie Cassel mail: jessie.cassel@ntm.eu
jimmybe Jimmy Bergvall mail: jimmy.bergvall@corren.se
jimmyha Jimmy Hanqvist mail: jimmy.hanqvist@corren.se
jimmyös Jimmy Österberg mail: jimmy.osterberg@ntm.eu
joakimeng Joakim Englund mail: joakim.englund@vt.se
Joakimgu Joakim Gustafsson mail: joakim.gustafsson@unt.se
joakimlu Joakim Lundquist mail: joakim.lundquist@corren.se
jockewi Jocke Winqvist mail: joakim.winqvist@corren.se
johanan Johan Andersson mail: johan.andersson@unt.se
johanba Johan Baggström mail: johan.b@annonstidningen.com
johanbe Johan Bergils mail: johan.bergils@nt.se
johanbu Johan Bülow mail: johan.bulow@corren.se
johanca Johan Cassman mail: johan.cassman@uppsalatidningen.se
johanga Johan Gardell mail: johan.gardell@gotlandsmedia.se
johanka Johan Karlgren mail: johan.karlgren@mvt.se
johankar Johan Karlsson mail: johan.karlsson@corren.se
johanma Johan Mattisson mail: johan.mattisson@gotlandsmedia.se
johanmi Johan Midner mail: johan.midner@ostgotamedia.se
johannaph Johanna PhillipsHuuva mail: johanna.phillips@norrbottensmedia.se
johannaso Johanna Soderling-Romest mail: johanna.soderling-romestrand@vt.se
johanno Johan Nordqvist mail: johan.nordqvist@nt.se
johansj Johan Sjöstrand mail: johan.sjostrand@nt.se
johanso Johan Sommansson mail: Johan.sommansson@nt.se
johansp Johan Sporrong mail: johan.sporrong@unt.se
johansu Johan Sundén mail: johan.sunden@gotlandsmedia.se
johanås Johan Åström mail: johan.a@annonstidningen.com
johnnyhu Johnny Husevik mail: johnny.husevik@unt.se
johnnyma Johnny Mattsson mail: johnny.mattsson@gotlandsmedia.se
jonasbo Jonas Bornmarker mail: jonas.bornmarker@gotlandsmedia.se
jonasbr Jonas Brodin mail: jonas.brodin@unt.se
jonasir Jonas Irebjörk mail: jonas.irebjork@unt.se
jonasli Jonas Lindahl mail: jonas.lindahl@unt.se
jonasma Jonas Mandorf mail: jonas.mandorf@teknomedia.se
jonaspe Jonas Persson mail: jonas.persson@norrbottensmedia.se
jonathango Jonathan Goderlöv mail: jonathan.goderlov@corren.se
jonathanso Jonathan Sohlberg mail: 
jonfu Jon (1) Funk mail: jon.funk@gotlandsmedia.se
jonfunk Jon Funk mail: jon.funk@gotlandsmedia.se
jonkä Jon Källberg mail: jon.kallberg@nt.se
jonnyni Jonny Nilsson mail: jonny.nilsson@norrbottensmedia.se
jorgenha Jörgen Hamber mail: jorgen.hamber@ntm.eu
jorgense Jörgen Sedholm mail: jorgen.sedholm@norrbottensmedia.se
josefinbr Josefin Brändholm mail: josefin.brandholm@ntm.eu
josefinka Josefine Kärrman mail: josefine.karrman@corren.se
josefinli Josefin Lindholm mail: josefin.lindholm@ntm.eu
juliaek Julia Ekengren mail: julia.ekengren@gotlandsmedia.se
kajsawr Kajsa Wretman mail: kajsa.wretman@ntm.eu
karinan Karin Andersson mail: karin.andersson@ntm.eu
karinbl Karin Blomqvist mail: karin.blomqvist@unt.se
karinla Karin Larsson mail: karin.larsson@uppsalatidningen.se
karinlar Karin Larsson mail: karin.larsson@uppsalatidningen.se
karinta Karin Thapper mail: karin.thapper@nt.se
karinåb Karin Åberg mail: karin.aberg@norrbottensmedia.se
katae Thussapon Meethong mail: katae@teknomedia.se
katarinaha Katarina Halvardsson mail: ninna@annonstidningen.com
katarinani Katarina Nilsson mail: katarina.nilsson@ntm.eu
katarinaza Katarina Zander mail: katarina.zander@sigtunabygden.se
katjafr Katja Fredriksson mail: 
kece Kenneth Cederqvist mail: kenneth.cederqvist@nt.se
kennethja Kenneth Jangsved mail: kenneth.jangsved@nt.se
kennethtr Kenneth Trybom mail: kenneth.trybom@nt.se
kentbe Kent Berg mail: kent.berg@ntm.eu
kenten Kent Engman mail: kent.engman@kuriren.com
kenthgu Kenth Gustavsson mail: kenth.gustafsson@corren.se
kenthrå Kenth Rånes mail: kenth.ranes@pitea-tidningen-se
kerstinbe Kerstin Behm mail: kerstin.behm@norrbottensmedia.se
kerstiner Kerstin Eriksson mail: kerstin.eriksson@unt.se
kiado Kia Dock mail: kia.dock@ntm.eu
kickica Kicki Edenhofer mail: kicki.edenhofer@corren.se
kimob Kim Oberpichler mail: kim.oberpichler@corren.se
kimst Kim Stens mail: kim.stens@gotlandspress.se
kimsv Kim Svensson mail: kim.svensson@ntm.eu
kimåk Kim Åkerwall mail: kim.akerwall@nt.se
kjell Kjell Åvall mail: kjell.avall@ntm.eu
kjellakejo Kjell-Åke Johansson mail: kjell-ake.johansson@ntm.eu
kjelljo Kjell Jönsson mail: kjell.jonsson@nt.se
kjellåkejo Kjell-Åke Johansson mail: kjell-ake.johansson@ntm.eu
konkvt Konkurs VT mail: 
kristermo Krister Monie mail: krister.monie@unt.se
kristianri Kristian Ring mail: kristian.ring@nt.se
kristinabj Kristina Björnfot mail: kristina.bjornfot@norrbottensmedia.se
kristinabr Kristina Brännare mail: kristina.brannare@norrbottensmedia.se
kristinagu Kristina Gustafsson mail: kristina.gustafsson@unt.se
kristinala Kristina Larsson mail: kristina.larsson@gotlandsmedia.se
kristinasa Kristina Sandman mail: kristina.sandman@norrbottensmedia.se
kristinti Kristin Tillman mail: kristin.tillman@ntm.eu
kristoferjo Kristofer Johnsson mail: kristofer.johnsson@vt.se
laidback Laidback Cargo mail: 
lars Lars Norén mail: lars.noren@nt.se
larsasi Larsa Sidbo mail: larsa.sidbo@mvt.se
larsbj Lars Björkens mail: lars.bjorkens@lohtsds.se
larsbjo Lars Björkman mail: lars.bjorkman@vt.se
larshe Lars Herlin mail: lars.herlin@gotlandsmedia.se
larska Lars Karlsson mail: lars.karlsson@kuriren.com
larsma Lars Mattsson mail: lars.mattsson@nt.se
larsmat Lars Mathlin mail: lars.mathlin@unt.se
larsne Lars Neuman mail: 
larspe Lars Persson mail: lars.persson@gotlandsmedia.se
larsto Lars Tomasson mail: lars.tomasson@corren.se
lenaal Lena Alm Stävlid mail: lena.alm@norrbottensmedia.se
lenabr Lena Broman-Tanndal mail: lena.broman@unt.se
lenada Lena Danell mail: lena.danell@norrbottensmedia.se
lenaje Lena Jenskog mail: lena.jenskog@ntm.eu
lenajo Lena Jonsson mail: lena.jonsson@ntm.eu
lenakv Lena Kvist mail: lena.kvist@corren.se
lenalo Lena Löfgren mail: lena.lofgren@corren.se
lenano Lena Nordström mail: lena.nordstrom@nt.se
lenaol Lena Olsson mail: lena.olsson@ntm.eu
lenape Lena Persson mail: lena.perssonl@gotlandsmedia.se
lenara Lena Ranerson mail: lena.ranerson@uppsalatidningen.se
lenawa Lena Wahlberg mail: lena.wahlberg@norrbottensmedia.se
lenawal Lena Walter mail: lena.walter@unt.se
lenaåk Lena Åkergren-Ohlsson mail: lena.akergren-ohlsson@nt.se
lenitali Lenita Lillich mail: lenita.lillich@sigtunabygden.se
lennartpe Lennart Petersson mail: lennart.petersson@ntm.eu
lennartth Lennart Thorsell mail: Lennart.Thorsell@norrbottensmedia.se
linacl Lina Classon mail: lina.classon@ntm.eu
lindabö Linda Trybom-Böckert mail: linda.trybom-bockert@ntm.eu
lindada Linda Daun mail: linda.daun@corren.se
lindajo Linda Johansson mail: linda.johansson@corren.se
lindany Linda Nyström mail: linda.nystrom@norrbottensmedia.se
linneael Linnea Elebring mail: linnea.elebring@corren.se
linnhö Linn Hökby mail: linn.hokby@ntm.eu
linnmo Linn Moberg mail: linn.a.moberg@ntm.eu
linusan Linus Andersson mail: linus.andersson@ntm.eu
lisabr Lisa Bratt mail: lisa.bratt@gotlandsmedia.se
lisahj Lisa Hjärpe mail: lisa.hjarpe@unt.se
lisasa Lisa Säfström mail: lisa.safstrom@unt.se
lisbethhe Lisbeth Hedstig mail: lisbeth.hedstig@inorr.se
lisbethro Lisbeth Rovasaari mail: lisbeth.rovasaari@norrbottensmedia.se
lisbethze Lisbeth Zetterström mail: lisbeth.zetterstrom@norrbottensmedia.se
liselottma Liselott Martinsson mail: liselott.martinsson@nt.se
lith Li Thurfjell mail: li.thurfjell@kuriren.com
lizpe Liz Pettersson mail: liz.pettersson@vt.se
lokusweb Lokus Webbokning mail: 
lokuswebco Lokus Webbokning CO mail: 
lokusweben Lokus Webbokning EN mail: 
lokuswebfb Lokus Webbokning FB mail: 
lokuswebgp Lokus Webbokning GP mail: 
lokuswebnk Lokus Webbokning NK mail: 
lokuswebnm Lokus Webbokning NMAB mail: 
lokuswebnt Lokus Webbokning NT mail: 
lokuswebpt Lokus Webbbokning PT mail: 
lokuswebunt lokus webbokningUNT mail: 
lokuswebvt Lokus Webbokning VT mail: 
lolasv Lola Svalbro mail: lola.svalbro@inorr.se
lornm XML Bokning Land och Rike NM mail: 
lorpt XML Bokning Land och Rike PT mail: 
lottaee Lotta Eek mail: lotta.eek@nt.se
lottaeek Eva-Lotta Eek mail: lotta.eek@unt.se
lottaka Lotta Karlsson mail: lotta.karlsson@corren.se
lottasy Lotta Syrén mail: lotta.syren@ntm.eu
lottasyren Lotta (2) Syrén mail: lotta.syren@ntm.eu
lottawe Lotta Wettergren mail: lotta.wettergren@corren.se
lottieda Lottie Dahlström mail: lottie.dahlstrom@nt.se
louisema Louise Magnusson mail: louise.magnusson@corren.se
ludvigni Ludvig Nilsson mail: ludvig.nilsson@norrbottensmedia.se
lukasös Lukas Österberg mail: lukas.osterberg@unt.se
mac AdBase Mactive mail: emil.sandbladh@ntm.eu
mac2 AdBase Mactive mail: emil.sandbladh@ntm.eu
macat AdBase Mactive AT mail: 
macco Corren Mactive mail: 
macen Extra Norr Mactive mail: 
macfb FB Mactive mail: 
macgp GP Test Mactive mail: 
macnk NK test Mactive mail: linda.nilsson@mactive.se
macnt NT test Mactive mail: 
macpt PT Test Mactive mail: 
macunt UNT Mactive mail: 
macvt VT Test Mactive mail: 
madeleinest Madeleine Stenslind mail: madeleine.stenslind@unt.se
magganj Margaretha Johansson mail: margaretha.johansson@corren.se
magnuswr Magnus Wranning mail: magnus.wranning@sigtunabygden.se
majkenbe Majken Bergman mail: majken.bergman@pitea-tidningen.se
malinan Malin Andersson mail: malin.andersson2@norrbottensmedia.se
malinbä Malin Bäckström mail: malin.backstrom@nt.se
malingu Malin Gustavsson mail: malin.gustavsson@unt.se
malinhe Malin Hedqvist mail: malin.hedqvist@pitea-tidningen.se
malinja Malin Jeansson mail: malin.jeansson@vt.se
malinle Malin Lewander mail: malin.lewander@unt.se
malinni Malin Nilsson-Lång mail: malin.nilsson-lang@norrbottensmedia.se
malinnil Malin Nilsson mail: malin.nilsson@ntm.eu
malinst Malin Stahre mail: malin.stahre@unt.se
Manus eftersökes Manus Eftersökes mail: 
Manus finns Manus Finns mail: 
Manus på Mail Manus på Mail mail: 
Manus på PDF Manus på PDF mail: 
marcuser Marcus Eriksson mail: marcus.eriksson@nt.se
marcusgy Marcus Gyllander mail: marcus.gyllander@nt.se
marcusle Marcus Lejonsjö mail: marcus.lejonsjo@nt.se
margaretabr Margareta Brolin mail: margareta.brolin@gotlandsmedia.se
margaretaer Margareta Eriksson mail: margareta.eriksson@gotlandsmedia.se
margarethaaj Margaretha Ajpe mail: margaretha.ajpe@gotlandspress.se
margarethama Margaretha Magnusson mail: margareta.magnusson@ntm.eu
margettejo Margette Johansson mail: margette.johansson@pitea-tidningen.se
mariaha Maria Hall mail: maria.hall@ntm.eu
mariaja Maria Jakobsson mail: maria.jakobsson@teknomedia.se
mariajan Maria Jansson mail: 
mariakr Maria Kruglyak mail: maria.kruglyak@ntm.eu
mariala Maria Larsson mail: maria.larsson@gotlandsmedia.se
marialan Maria Landqvist mail: maria.landqvist@corren.se
marialar Maria Larsson mail: maria.larsson@ntm.eu
marialu Maria Lundqvist mail: maria.lundqvist@pitea-tidningen.se
marianael Mariana Eld mail: mariana.eld@norrbottensmedia.se
marianali Mariana Lindner mail: mariana.lindner@nt.se
mariani Maria Nilsson mail: maria.nilsson@inorr.se
mariannesu Marianne Sundberg mail: marianne.sundberg@ntm.eu
marianneöh Marianne Öhman mail: marianne.ohman@pitea-tidningen.se
mariansa Marian Sarenbrant mail: marian.sarenbrant@sigtunabygden.se
mariany Maria Nylund mail: maria.nylund@unt.se
mariaoh Maria Ohlsson mail: maria.ohlsson@ntm.eu
mariasa Maria Salomonsson mail: maria.salomonsson@inorr.se
mariash Maria Sharma mail: maria@annonstidningen.com
mariatj Maria Tjernström mail: maria.tjernstrom@corren.se
marieah Marie Ahlgren mail: marie.ahlgren@gotlandsmedia.se
marieanneni Marie-Anne Nilsson mail: marieanne.nilsson@norrbottensmedia.se
marieda Marie Lindgren mail: marie.lindgren@mvt.se
mariegu Marie Gustafsson mail: marie.gustafsson@unt.se
marielouiseb Marie-Louise Bergman mail: marielouise.bergman@norrbottensmedia.se
marieni Marie Nilsson mail: marie.nilsson@radiofour.se
mariepe Marie Pettersson mail: marie.pettersson@ntm.eu
mariewe Marie Wenngren mail: marie.wenngren@unt.se
marima Mari Malm mail: mari.malm@nt.se
maritabl Marita Blomqvist mail: marita.blomqvist@unt.se
maritam Marita Mörtzell mail: marita.mortzell@norrbottensmedia.se
maritaåh Marita Åhman mail: marita.ahman@nt.se
markuska Markus Karlsson Zerpe mail: markus.karlsson@norrbottensmedia.se
martenbr Mårten Britse mail: marten.britse@gotlandsmedia.se
martinaah Martina Aho mail: marrtina.aho@norrbottensmedia.se
martinpa Martin Pawlowski mail: martin.pawlowski@nt.se
martintr Martin Trozell mail: martin.trozell@ntm.eu
martinve Martin Vestin mail: martin.vestin@ntm.eu
mathiasöh Mattias Öhrman mail: mathias.ohrman@corren.se
matildaan Matilda Andersson mail: matilda.andersson@ntm.eu
matildael Matilda Elfvingsson mail: Matilda.Elfvingsson@ntm.eu
matseh Mats Ehnbom mail: mats.ehnbom@kuriren.com
matsjo Mats Johansson mail: mats.johansson@corren.se
matsös Mats Österberg mail: mats.osterberg@uppsalatidningen.se
mattiaser Mattias Ergul mail: mattias.ergul@nt.se
mattiasol Mattias Olson mail: mattias.olson@vt.se
matzge Matz Gelin mail: matz.gelin@unt.se
maudni Maude Nilsson mail: maude.nilsson@inorr.se
maxbe Max Bergström mail: max.bergstrom@ntm.eu
miala Mia Larsson mail: mia.larsson@gotlandsmedia.se
miali Mia Lindh mail: mia.lindh@unt.se
miator Mia Törnlöf mail: mia.tornlof@gotlandsmedia.se
micaelsa Micael Sandell mail: micael.sandell@ntm.eu
michaelahl Michael Ahl mail: michael.ahl@kuriren.com
michaelca Michael Castellane mail: michael.castellane@unt.se
michaelho Michael Holmberg mail: michael.holmberg@vt.se
michaelsc Michael Schillerström mail: michael.schillerstrom@gotlandsmedia.se
mikaelbl Mikael Blomqvist mail: mikael.blomqvist@unt.se
mikaelli Mikael Lindroth mail: mikael.lindroth@nt.se
mikaellin Mikael Lindgren mail: mikael.lindgren@mvt.se
Mikaellu Mikael Lundin mail: mikael.lundin@ntm.eu
mikaelog Mikael Ogestad mail: mikael.ogestad@gotlandsmedia.se
mikaelol Mikael Olovsson mail: mikael.olovsson@ntm.eu
mikaelpa Mikael Paulsson mail: mikael.paulsson@ntm.eu
mikaelsj Mikael Sjöwall mail: mikael.sjowall@folkbladet.se
mirjafa Mirja Faarinen mail: mirja.faarinen@norrbottensmedia.se
mirjahi Mirja Hilltorp mail: mirja.hilltorp@nt.se
monalisamo Mona-Lisa Modin mail: monalisa.modin@uppsalatidningen.se
monicali Monica Lierud mail: monica.lierud@inorr.se
monicalu Monica Lundström mail: monica.lundstrom@inorr.se
monicama Monica Magnström mail: monica.magnstrom@norrbottensmedia.se
monikabe Monika Berglund mail: monika.berglund@norrbottensmedia.se
monikast Monika Strand mail: monika.strand@norrbottensmedia.se
monikatg Monika T Gustavsson mail: monika.t.gustavsson@ntm.eu
mssco CO MSS mail: 
mssfb FB MSS mail: 
mssgm GM MSS mail: malin.glimhed@ntm.eu
mssnm NM MSS mail: 
mssnt NT MSS mail: marknadsservice@ntm.eu
mssost OST MSS mail: 
msspt PT MSS mail: daniel.thapper@ntm.eu
mssunt UNT MSS mail: 
mssut UT MSS mail: marknadsservice@ntm.eu
mssvt VT MSS mail: 
mårtenfr Mårten Fritjofsson mail: marten.fritjofsson@unt.se
märthahå Märtha Hågeryd mail: martha.hageryd@corren.se
Nadali Nada Lindberg mail: Nada.Lindberg@unt.se
natalieli Natalie Lindholm mail: natalie.lindholm@ntm.eu
nicklasis Nicklas Isaksson mail: nicklas.isaksson@norrbottensmedia.se
niclasde Niclas Derby mail: niclas.derby@teknomedia.se
niclasfo Niclas Forslund mail: niclas.forslund@vt.se
niklasan Niklas Andersson mail: niklas.andersson@nt.se
niklashj Niklas Hjelm mail: niklas.hjelm@ntm.eu
niklaspe Niklas Pekkari mail: niklas.pekkari@norrbottensmedia.se
niklasti Niklas Tillberg mail: niklas.tillberg@pitea-tidningen.se
nilska Nils-Peter Kalmér mail: Nils-Peter.Kalmer@corren.se
ninano Nina Nordlund mail: nina.nordlund@norrbottensmedia.se
nmannons annons NM mail: whera.hellstrom@norrbottensmedia.se
noorme Noor Metti mail: 
ntannons Annonsförsäljnin NT mail: 
ntannons2 annons nt mail: 
ntbeg Begravningsbyrå NT mail: malin.backstrom@nt.se
ntinnesälj Innesälj NT mail: ntannonsinne@nt.se
ntmatelje  Atelje mail: emelie.johansson@ntm.eu
ntnya Innesälj NT NYA mail: 
olahe Ola Hedman mail: ola.hedman@norrbottensmedia.se
olape Ola Pettersson mail: ola.pettersson@vt.se
olofbe Olof Berggren mail: olof.berggren@pitea-tidningen.se
ornefalk Magnus Ornefalk mail: magnus.ornefalk@nt.se
outisa Outi Salo mail: outi.salo@unt.se
ovejo Ove Johansson mail: ove.johansson@norrbottensmedia.se
ovejoh Ove Johansson mail: ove.johansson@teknomedia.se
panmingye Panming Ye mail: panming.ye@teknomedia.se
parli Pär Lindegren mail: par.lindegren@folkbladet.se
patricewe Patrice Wedlund mail: patrice.wedlund@corren.se
patriche Patric Hellman mail: patric.hellman@meranorrkoping.se
patricto Patric Torstensson mail: patric.torstensson@uppsalatidningen.se
patrikbj Patrik Björkander mail: patrik.bjorkander@gotlandsmedia.se
patrikfa Patrik Falk mail: patrik.falk@mvt.se
patrikhi Patrik Hillman mail: patrik.hillman@unt.se
patrikno Patrik Nordgaard mail: patrik.nordgaard@gotlandsmedia.se
paulatj Paula Tjädermo mail: paula.tjadermo@corren.se
pederst Peder Stockman mail: peder.stockman@norrbottensmedia.se
pederwa Peder Wahlström mail: peder.wahlstrom@nt.se
perhenrikpe Per-Henrik Persson mail: per-henrik.persson@pitea-tidningen.se
pernillaja Pernilla Jansdotter mail: pernilla.jansdotter@unt.se
pernillama Pernilla Malmström mail: pernilla.malmstrom@pitea-tidningen.se
perod Per Oddman mail: per.oddman@corren.se
peterbä Peter Bäcklund mail: 
peterka Peter Karlsson mail: peter.karlsson@vt.se
peterlu Peter Lundberg mail: peter.lundberg@ntm.eu
peterny Peter Nyström mail: peter.nystrom@corren.se
peterra Peter Ranada mail: peter.ranada@corren.se
petersa Peter Sandberg mail: peter@norrauppland.se
peterte Peter Tegelberg mail: peter.tegelberg@unt.se
peteruh Peter Uhman mail: peter.uhman@nt.se
petraah Petra Ahdrian mail: petra.ahdrian@gotlandsmedia.se
petrais Petra Israelsson mail: petra.israelsson@unt.se
petrawe Petra Westring mail: petra.westring@ntm.eu
petriha Petri Hämäläinen mail: petri.hamalainen@corren.se
petterer Petter Eriksson mail: petter.eriksson@unt.se
philipca Philip Carlfjord mail: 
pontuscr Pontus Cronemyr mail: pontus.cronemyr@nt.se
PPetré Pernilla Petré mail: 
Prao Prao Corren mail: 
prodvik prodvik prodvik mail: 
ptannons annons PT mail: marianne.ohman@pitea-tidningen.se
rawadni Rawad Nissan mail: rawad.nissan@nt.se
rebeccapi Rebecca Pihl mail: rebecca.pihl@teknomedia.se
reginabl Regina Blomster mail: regina.blomster@sigtunabygden.se
rikardaf Rikard Af Uhr mail: rikard.afuhr@unt.se
robertan Robert Anglöw mail: robert.anglow@norrbottensmedia.se
robertbe Robert Bergenudd mail: robert.bergenudd@mvt.se
robertber Robert Berthagen mail: robert.berthagen@unt.se
robertbert Robert Berthagen mail: robert.berthagen@unt.se
roberthj Robert Hjert mail: robert.hjert@norrbottensmedia.se
robertka Robert Karlsson mail: robert.karlsson@ntm.eu
robertni Robert Nilsson mail: robert.nilsson@norrbottensmedia.se
rogeran Roger Andersson mail: roger.andersson@vt.se
rogerka Roger Karlsson mail: roger.karlsson@ntm.eu
rolandli Roland Lindgren mail: roland.lindgren@norrbottensmedia.se
rolandma Roland Mannertun mail: roland.mannertun@nt.se
rolandvi Roland Viklund mail: 
rolfto Rolf Törnström mail: rolf.tornström@corren.se
rolfwa Rolf Wahlgren mail: rolf.wahlgren@gotlandsmedia.se
rosmariekl Ros-Marie Klippmark mail: rosmarie.klippmark@norrbottensmedia.se
rubenfa Ruben Fast mail: ruben.fast@ntm.eu
sagami Saga Mikander mail: saga.mikander@nt.se
samuelni Samuel Nilsson mail: samuel.nilsson@nt.se
sandrahe Sandra Hederstedt mail: sandra.hederstedt@gotlandsmedia.se
sandrape Sandra Pettersson mail: sandra.pettersson@inorr.se
sandrasv Sandra Svensson mail: sandra.svensson@mvt.se
sannasv Sanna Svanström mail: sanna.svanstrom@unt.se
saraba Sara Ballester mail: sara.ballester@ntm.eu
saraem Sara Emanuelsson mail: sara.emanuelsson@norrbottensmedia.se
saraen Sara Engelmark mail: sara.engelmark@norrbottensmedia.se
Sarajo Sara Jonsson mail: sara.jonsson@norrbottensmedia.se
sariva Sari Väyrynen mail: Sari.Vayrynen@ntm.eu
scanner Annonsscanner Ascanner mail: nkascanner@kuriren.com
sebastianiv Sebastian Iversen mail: sebastian.iversen@norrbottensmedia.se
sebastiansa Sebastian Sandsten mail: sebastian.sandsten@pitea-tidningen.se
sebastiansw Sebastian Swande mail: sebastian.swande@gotlandspress.se
serryann Serry-Ann Andersson mail: serryann.andersson@nt.se
shezimu Shezi Muhammed mail: shezi.muhammed@unt.se
sivga Siv Gabrielsson mail: siv.gabrielsson@gotlandsmedia.se
sladjanajo Sladjana Jovanova mail: 
sofiaca Sofia Carlsson mail: sofia.carlsson@ntm.eu
sofiafo Sofia Forsberg mail: sofia.forsberg@norrbottensmedia.se
sofiaho Sofia Holm mail: sofia.holm@unt.se
solveiglö Solveig Lövgren mail: solveig.lovgren@kuriren.com
Sophiekr Sophie Kronqvist mail: sophie.kronqvist@folkbladet.se
sourabi Soura Bilal mail: soura.bilal@ntm.eu
staffangu Staffan Gustafsson mail: staffan.gustafsson@corren.se
staffanli Staffan Lind mail: staffan.lind@kuriren.com
stefaner Stefan Eriksson mail: stefan.eriksson@norrbottensmedia.se
stefanhe Stefan Hedkvist mail: stefan.hedqvist@pitea-tidningen.se
stefanja Stefan Jacobsson mail: stefan.jacobsson@gotlandspress.se
stefanjo Stefan Jonsson mail: stefan.jonsson@gotlandsmedia.se
stefanni Stefan Nilsson mail: stefan.nilsson@ntm.eu
stefansö Stefan Söderlund mail: stefan.soderlund@ntm.eu
stinabu Stina Bucht-Larsson mail: stina@annonstidningen.com
sturebe Sture Bergman mail: sture.bergman@kuriren.com
susannear Susanne Årbro mail: susanne.arbro@norrbottensmedia.se
susannesi Susanne Simonsson mail: susanne.simonsson@nt.se
sussijo Sussi Johansson mail: sussi.johansson@gotlandsmedia.se
suzanneja Suzanne Jansson mail: suzanne.jansson@unt.se
svenericjö Sven-Eric Jönsson mail: 
svenerikjä Sven-Erik Järnberg mail: 
Sylviean Sylvie Andersson mail: sylvie@norrauppland.se
SäljMotala Sälj Motala mail: marie.dahl@mvt.se
sörenan Sören Andersson mail: Soren.Andersson@nt.se
teknomedia  Teknomedia mail: jasmin.zejnilagic@teknomedia.se
test  test mail: 
theobl Theo Blanco mail: theo.blanco@unt.se
theresejo Therese Johansson mail: therese.johansson@ntm.eu
theresekä Therese Kälvelind mail: therese.kalvelind@mvt.se
thereselö Therese Löfgren mail: therese.lofgren@unt.se
theresesj Therese Sjöholm mail: therese.sjoholm@corren.se
thobiasli Thobias Lindqvist mail: thobias.linqvist@meralinkoping.se
thomasan Thomas Andersson mail: thomas.andersson@nt.se
thomasar Thomas Arvidsson mail: thomas.arvidsson@ntm.eu
thomasba Thomas Bäckman mail: thomas.backman@gotlandsmedia.se
thomasfl Thomas Fliesberg mail: thomas.fliesberg@unt.se
thomasfr Thomas Fransson mail: thomas.fransson@folkbladet.se
thomashu Thomas Hultberg mail: thomas.hultberg@pitea-tidningen.se
thomassv Thomas Svall mail: thomas.svall@nt.se
timpe Tim Pettersson mail: tim.pettersson@ntm.eu
tinala Tina Larsson mail: tina.larsson@ntm.eu
tinape Tina Persson mail: tina.persson@corren.se
tobbest Tobbe Stuhre mail: tobbe.stuhre@gotlandsmedia.se
tobiaslu Tobias Lundin mail: tobias.lundin@norrbottensmedia.se
tomasho Tomas Holmgren mail: tomas.holmgren@pitea-tidningen.se
tomasli Tomas Lindh mail: tomas.lindh@sigtunabygden.se
tomaslin Tomas Lindberg mail: tomas.lindberg@unt.se
tomasol Tomas Olson mail: tomas.olson@vt.se
tomer Tom Eriksson mail: tom.eriksson@unt.se
tommybo Tommy Bodén mail: tommy.boden@gotlandsmedia.se
tommyja Tommy Jalar mail: tommy@annonstidningen.com
torbjörnås Torbjörn Åswärdh mail: torbjorn.aswardh@ostgotamedia.se
tovewi Tove Wikström mail: tove.wikstrom@uppsalatidningen.se
trafficunt UNT Traffic mail: 
ulf1 Ulf  - trasig Norrbom mail: ulf.norrbom@corren.se
ulfn Ulf Norrbom mail: ulf.norrbom@ntm.eu
ulfny Ulf Nyman mail: 
ullaaj Ulla Äjlén mail: ulla.ajlen@corren.se
ullaan Ulla Andersson mail: ulla.andersson@nt.se
ullabrittli Ulla-Britt Lind mail: ullabritt.lind@norrbottensmedia.se
ullakä Ulla Kärrman mail: ulla.karrman@ntm.eu
ulrikari Ulrika Rixon mail: ulrika.rixon@ntm.eu
unit UNiT Produktion mail: mikael.lundin@ntm.eu
UNT, Innesälj Innesälj UNT mail: foretagsannons@unt.se
untannons annons unt mail: 
untavreg UNT AVREG mail: petra.israelsson@unt.se
untbegrav UNT Begravningsbyrå mail: petra.israelsson@unt.se
untekonomi Ekonomi UNT mail: 
untguld Guld Unt mail: petra.israelsson@unt.se
untinaktiv UNT Inaktiv mail: petra.israelsson@unt.se
upsalesapi Upsales API mail: daniel.thapper@ntm.eu
upsalesimport Upsales Import mail: daniel.thapper@ntm.eu
urbanan Urban Anderzon mail: urban.anderzon@norrbottensmedia.se
urband Urban Wallton mail: urban.wallton@norrbottensmedia.se
urbanni Urban Nilsson mail: urban.nilsson@norrbottensmedia.se
urbanwi Urban Wikberg mail: urban.wikberg@norrbottensmedia.se
urbanze Urban Zetterström mail: urban.zetterstrom@norrbottensmedia.se
utannons annons UT mail: annons@uppsalatidningen.se
vandyer Vandy Eriksson mail: vandy.eriksson@pitea-tidningen.se
victoriaka Victoria Karlsson mail: victoria.karlsson@corren.se
victoriani Victoria Nilsson mail: victoria.nilsson@ntm.eu
vikarie Vikarie PT mail: 
vikarie1 Vik 1 GP mail: 
viktoren Viktor Engberg mail: viktor.engberg@ntm.eu
viktorhe Viktoria Hedlund mail: viktoria.hedlund@inorr.se
viktoriabe Viktoria Bellqvist mail: viktoria.bellqvist@unt.se
viktoriali Viktoria Liao mail: viktoria.liao@ntm.eu
vivecaca Viveca Calmunger mail: viveca.calmunger@vt.se
vivekaen Viveka Engholm mail: viveka.engholm@norrbottensmedia.se
vtannons Produktion VT mail: 
vtannonser Annons VT mail: vtannons@vt.se
vtorder Order VT mail: vt.annons@vt.se
watchBO BackOffice Övervakning mail: 
wherahe Whera Hellström mail: whera.hellstrom@norrbottensmedia.se
wivekawa Wiveka Wahlund mail: wiveka.wahlund@unt.se
xmlimport Autoimport XML mail: 
Xtremeapi Xtreme API mail: 
ylwaol Ylwa Olsson mail: ylwa.olsson@norrbottensmedia.se
zandrajo Zandra Jonsson mail: zandra.jonsson@inorr.se
zarabe Zara Bejmyr mail: zara.bejmyr@unt.se
Zendesk  Zendesk mail: dennis.stromberg@ntm.eu
åsaha Åsa Hanell mail: asa.hanell@folkbladet.se
åsahe Åsa Hederstedt mail: asa.hederstedt@gotlandsmedia.se
åsajo Åsa Johansson mail: asa.johansson@gotlandsmedia.se
åsati Åsa Tibring mail: asa@norrauppland.se
åsaull Åsa Ullman mail: asa.ullman@ntm.eu
